tanggal,positif,negatif,inconclusive,jumlah_sampel,id
2020-05-27 00:00:00,0,2,0,2,1
2020-05-28 00:00:00,1,54,0,55,2
2020-05-29 00:00:00,35,314,0,349,3
2020-05-30 00:00:00,3,114,0,117,4
2020-05-31 00:00:00,1,135,0,136,5
2020-06-01 00:00:00,2,105,0,107,6
2020-06-02 00:00:00,23,567,0,590,7
2020-06-03 00:00:00,30,504,0,534,8
2020-06-04 00:00:00,17,399,1,417,9
2020-06-05 00:00:00,12,395,0,407,10
2020-06-06 00:00:00,27,431,0,458,11
2020-06-07 00:00:00,4,107,0,111,12
2020-06-08 00:00:00,38,403,0,441,13
2020-06-09 00:00:00,11,745,1,757,14
2020-06-10 00:00:00,7,230,0,237,15
2020-06-11 00:00:00,24,269,0,293,16
2020-06-12 00:00:00,12,230,0,242,17
2020-06-13 00:00:00,46,259,0,305,18
2020-06-14 00:00:00,48,237,0,285,19
2020-06-15 00:00:00,136,802,0,938,20
2020-06-16 00:00:00,109,1882,2,1993,21
2020-06-17 00:00:00,72,1204,3,1279,22
2020-06-18 00:00:00,86,524,3,613,23
2020-06-19 00:00:00,8,353,0,361,24
2020-06-20 00:00:00,9,246,0,255,25
2020-06-21 00:00:00,11,286,0,297,26
2020-06-22 00:00:00,31,687,2,720,27
2020-06-23 00:00:00,72,1070,1,1143,28
2020-06-24 00:00:00,42,889,2,933,29
2020-06-25 00:00:00,26,857,0,883,30
2020-06-26 00:00:00,39,845,0,884,31
2020-06-27 00:00:00,23,1026,0,1049,32
2020-06-28 00:00:00,11,566,1,578,33
2020-06-29 00:00:00,61,1157,0,1218,34
2020-06-30 00:00:00,80,1631,0,1711,35
2020-07-01 00:00:00,40,1030,2,1072,36
2020-07-02 00:00:00,46,988,0,1034,37
2020-07-03 00:00:00,34,1153,1,1188,38
2020-07-04 00:00:00,19,428,0,447,39
2020-07-05 00:00:00,5,115,0,120,40
2020-07-06 00:00:00,68,1180,0,1248,41
2020-07-07 00:00:00,146,1135,0,1281,42
2020-07-08 00:00:00,86,2788,10,2884,43
2020-07-09 00:00:00,60,1383,15,1458,44
2020-07-10 00:00:00,96,1031,4,1131,45
2020-07-11 00:00:00,12,545,0,557,46
2020-07-12 00:00:00,2,121,0,123,47
2020-07-13 00:00:00,37,336,0,373,48
2020-07-14 00:00:00,44,350,0,394,49
2020-07-15 00:00:00,47,709,0,756,50
2020-07-16 00:00:00,30,1186,1,1217,51
2020-07-17 00:00:00,66,531,0,597,52
2020-07-18 00:00:00,36,1145,0,1181,53
2020-07-19 00:00:00,10,1110,14,1134,54
2020-07-20 00:00:00,24,1521,1,1546,55
2020-07-21 00:00:00,71,2968,1,3040,56
2020-07-22 00:00:00,87,1641,0,1728,57
2020-07-23 00:00:00,95,1034,3,1132,58
2020-07-24 00:00:00,47,657,0,704,59
2020-07-25 00:00:00,46,615,0,661,60
2020-07-26 00:00:00,8,432,1,441,61
2020-07-27 00:00:00,78,531,7,616,62
2020-07-28 00:00:00,136,705,0,841,63
2020-07-29 00:00:00,81,1490,1,1572,64
2020-07-30 00:00:00,107,1359,3,1469,65
2020-07-31 00:00:00,78,1098,1,1177,66
2020-08-01 00:00:00,49,327,0,376,67
2020-08-02 00:00:00,62,478,0,540,68
2020-08-03 00:00:00,78,687,5,770,69
2020-08-04 00:00:00,149,1306,2,1457,70
2020-08-05 00:00:00,162,1437,11,1610,71
2020-08-06 00:00:00,135,1295,1,1431,72
2020-08-07 00:00:00,174,1193,5,1372,73
2020-08-08 00:00:00,235,954,0,1189,74
2020-08-09 00:00:00,194,243,0,437,75
2020-08-10 00:00:00,36,319,1,356,76
2020-08-11 00:00:00,113,858,3,974,77
2020-08-12 00:00:00,179,797,2,978,78
2020-08-13 00:00:00,197,1508,6,1711,79
2020-08-14 00:00:00,433,1472,4,1909,80
2020-08-15 00:00:00,198,908,0,1106,81
2020-08-16 00:00:00,52,300,0,352,82
2020-08-17 00:00:00,42,318,0,360,83
2020-08-18 00:00:00,79,403,1,483,84
2020-08-19 00:00:00,155,1155,4,1314,85
2020-08-20 00:00:00,207,853,4,1064,86
2020-08-21 00:00:00,77,739,2,818,87
2020-08-22 00:00:00,110,996,0,1106,88
2020-08-23 00:00:00,42,602,3,647,89
2020-08-24 00:00:00,109,753,1,863,90
2020-08-25 00:00:00,259,2139,14,2412,91
2020-08-26 00:00:00,170,1206,5,1381,92
2020-08-27 00:00:00,138,1284,0,1422,93
2020-08-28 00:00:00,366,1565,9,1940,94
2020-08-29 00:00:00,322,1366,10,1698,95
2020-08-30 00:00:00,79,312,0,391,96
2020-08-31 00:00:00,122,1024,4,1150,97
2020-09-01 00:00:00,293,1635,7,1935,98
2020-09-02 00:00:00,421,1675,20,2116,99
2020-09-03 00:00:00,385,1383,10,1778,100
2020-09-04 00:00:00,237,1335,6,1578,101
2020-09-05 00:00:00,219,780,24,1023,102
2020-09-06 00:00:00,136,592,1,729,103
2020-09-07 00:00:00,228,897,9,1134,104
2020-09-08 00:00:00,490,1288,27,1805,105
2020-09-09 00:00:00,373,1202,24,1599,106
2020-09-10 00:00:00,453,1291,16,1760,107
2020-09-11 00:00:00,353,1103,13,1469,108
2020-09-12 00:00:00,330,912,16,1258,109
2020-09-13 00:00:00,75,923,2,1000,110
2020-09-14 00:00:00,143,876,7,1026,111
2020-09-15 00:00:00,275,1433,7,1715,112
2020-09-16 00:00:00,334,1549,14,1897,113
2020-09-17 00:00:00,269,1561,8,1838,114
2020-09-18 00:00:00,391,1637,46,2074,115
2020-09-19 00:00:00,289,1502,38,1829,116
2020-09-20 00:00:00,123,1670,1,1794,117
2020-09-21 00:00:00,150,1027,2,1179,118
2020-09-22 00:00:00,283,1462,14,1759,119
2020-09-23 00:00:00,341,1563,24,1928,120
2020-09-24 00:00:00,475,1924,19,2418,121
2020-09-25 00:00:00,281,1699,11,1991,122
2020-09-26 00:00:00,303,1534,2,1839,123
2020-09-27 00:00:00,100,835,1,936,124
2020-09-28 00:00:00,241,716,30,987,125
2020-09-29 00:00:00,603,1093,121,1817,126
2020-09-30 00:00:00,631,1415,72,2118,127
2020-10-01 00:00:00,575,1947,30,2552,128
2020-10-02 00:00:00,396,1909,24,2329,129
2020-10-03 00:00:00,231,2037,4,2272,130
2020-10-04 00:00:00,240,1279,3,1522,131
2020-10-05 00:00:00,174,1187,5,1366,132
2020-10-06 00:00:00,352,2092,7,2451,133
2020-10-07 00:00:00,405,2714,11,3130,134
2020-10-08 00:00:00,370,2998,21,3389,135
2020-10-09 00:00:00,345,3578,26,3949,136
2020-10-10 00:00:00,402,2771,18,3191,137
2020-10-11 00:00:00,218,1670,5,1893,138
2020-10-12 00:00:00,168,1716,13,1897,139
2020-10-13 00:00:00,513,2926,50,3489,140
2020-10-14 00:00:00,537,3051,54,3642,141
2020-10-15 00:00:00,435,2497,47,2979,142
2020-10-16 00:00:00,370,2544,56,2970,143
2020-10-17 00:00:00,396,2017,26,2439,144
2020-10-18 00:00:00,215,961,8,1184,145
2020-10-19 00:00:00,611,1062,21,1694,146
2020-10-20 00:00:00,700,2212,52,2964,147
2020-10-21 00:00:00,886,2797,31,3714,148
2020-10-22 00:00:00,844,2628,12,3484,149
2020-10-23 00:00:00,536,3312,19,3867,150
2020-10-24 00:00:00,424,2340,10,2774,151
2020-10-25 00:00:00,232,1023,1,1256,152
2020-10-26 00:00:00,218,849,2,1069,153
2020-10-27 00:00:00,449,1950,10,2409,154
2020-10-28 00:00:00,436,2386,7,2829,155
2020-10-29 00:00:00,447,1928,12,2387,156
2020-10-30 00:00:00,231,1273,6,1510,157
2020-10-31 00:00:00,321,1991,24,2336,158
2020-11-01 00:00:00,173,648,0,821,159
2020-11-02 00:00:00,338,1654,17,2009,160
2020-11-03 00:00:00,656,2772,15,3443,161
2020-11-04 00:00:00,651,2738,20,3409,162
2020-11-05 00:00:00,767,3377,32,4176,163
2020-11-06 00:00:00,720,3391,24,4135,164
2020-11-07 00:00:00,824,3286,8,4118,165
2020-11-08 00:00:00,525,1877,12,2414,166
2020-11-09 00:00:00,348,1405,7,1760,167
2020-11-10 00:00:00,914,3400,25,4339,168
2020-11-11 00:00:00,888,3230,22,4140,169
2020-11-12 00:00:00,855,3280,30,4165,170
2020-11-13 00:00:00,895,3076,19,3990,171
2020-11-14 00:00:00,777,2801,6,3584,172
2020-11-15 00:00:00,526,1980,4,2510,173
2020-11-16 00:00:00,837,1842,17,2696,174
2020-11-17 00:00:00,1114,3560,52,4726,175
2020-11-18 00:00:00,1441,3317,18,4776,176
2020-11-19 00:00:00,949,2901,12,3862,177
2020-11-20 00:00:00,1082,3410,6,4498,178
2020-11-21 00:00:00,1065,2869,10,3944,179
2020-11-22 00:00:00,794,1934,6,2734,180
2020-11-23 00:00:00,1040,2763,12,3815,181
2020-11-24 00:00:00,1202,3695,29,4926,182
2020-11-25 00:00:00,1424,3673,18,5115,183
2020-11-26 00:00:00,1198,3794,28,5020,184
2020-11-27 00:00:00,1098,4879,21,5998,185
2020-11-28 00:00:00,951,3315,11,4277,186
2020-11-29 00:00:00,668,2515,10,3193,187
2020-11-30 00:00:00,962,2637,23,3622,188
2020-12-01 00:00:00,1376,4408,29,5813,189
2020-12-02 00:00:00,1624,4669,24,6317,190
2020-12-03 00:00:00,1647,5686,39,7372,191
2020-12-04 00:00:00,1585,5301,35,6921,192
2020-12-05 00:00:00,1328,3971,4,5303,193
2020-12-06 00:00:00,497,1731,3,2231,194
2020-12-07 00:00:00,561,1157,2,1720,195
2020-12-08 00:00:00,1391,3658,6,5055,196
2020-12-09 00:00:00,1303,3995,10,5308,197
2020-12-10 00:00:00,1239,3691,5,4935,198
2020-12-11 00:00:00,1812,4783,17,6612,199
2020-12-12 00:00:00,1641,4681,44,6366,200
2020-12-13 00:00:00,831,2009,8,2848,201
2020-12-14 00:00:00,1110,2786,5,3901,202
2020-12-15 00:00:00,1830,4729,34,6593,203
2020-12-16 00:00:00,1692,4033,31,5756,204
2020-12-17 00:00:00,1871,4635,16,6522,205
2020-12-18 00:00:00,1850,4598,8,6456,206
2020-12-19 00:00:00,1752,3957,7,5716,207
2020-12-20 00:00:00,917,1726,0,2643,208
2020-12-21 00:00:00,869,1943,8,2820,209
2020-12-22 00:00:00,1289,2895,18,4202,210
2020-12-23 00:00:00,1708,5140,19,6867,211
2020-12-24 00:00:00,1979,4944,21,6944,212
2020-12-25 00:00:00,1353,3415,16,4784,213
2020-12-26 00:00:00,914,2390,16,3320,214
2020-12-27 00:00:00,887,2698,16,3601,215
2020-12-28 00:00:00,730,2054,22,2806,216
2020-12-29 00:00:00,1842,4875,16,6733,217
2020-12-30 00:00:00,2189,6045,20,8254,218
2020-12-31 00:00:00,1932,4285,13,6230,219
2021-01-01 00:00:00,893,2663,11,3567,220
2021-01-02 00:00:00,674,1615,4,2293,221
2021-01-03 00:00:00,1194,2195,4,3393,222
2021-01-04 00:00:00,1401,2766,17,4184,223
2021-01-05 00:00:00,1999,4134,6,6139,224
2021-01-06 00:00:00,2726,5421,12,8159,225
2021-01-07 00:00:00,2347,4489,10,6846,226
2021-01-08 00:00:00,2347,5002,11,7360,227
2021-01-09 00:00:00,1916,3583,23,5522,228
2021-01-10 00:00:00,1185,2232,8,3425,229
2021-01-11 00:00:00,1203,2112,7,3322,230
2021-01-12 00:00:00,2924,5597,17,8538,231
2021-01-13 00:00:00,3268,5363,14,8645,232
2021-01-14 00:00:00,2803,5324,6,8133,233
2021-01-15 00:00:00,2722,6368,21,9111,234
2021-01-16 00:00:00,2541,4500,1,7042,235
2021-01-17 00:00:00,1407,2764,7,4178,236
2021-01-18 00:00:00,1963,3230,10,5203,237
2021-01-19 00:00:00,3447,7046,18,10511,238
2021-01-20 00:00:00,3092,5677,16,8785,239
2021-01-21 00:00:00,3959,6959,35,10953,240
2021-01-22 00:00:00,3829,5843,48,9720,241
2021-01-23 00:00:00,2437,3731,30,6198,242
2021-01-24 00:00:00,1547,2605,5,4157,243
2021-01-25 00:00:00,2277,3220,19,5516,244
2021-01-26 00:00:00,3098,5091,28,8217,245
2021-01-27 00:00:00,3674,6274,78,10026,246
2021-01-28 00:00:00,3635,6281,79,9995,247
2021-01-29 00:00:00,3536,5893,58,9487,248
2021-01-30 00:00:00,2689,4684,35,7408,249
2021-01-31 00:00:00,1334,2567,37,3938,250
2021-02-01 00:00:00,2136,3559,27,5722,251
2021-02-02 00:00:00,3490,6464,36,9990,252
2021-02-03 00:00:00,3216,5803,55,9074,253
2021-02-04 00:00:00,2904,5622,28,8554,254
2021-02-05 00:00:00,3521,6496,62,10079,255
2021-02-06 00:00:00,2962,5536,55,8553,256
2021-02-07 00:00:00,1596,2923,40,4559,257
2021-02-08 00:00:00,1650,3133,43,4826,258
2021-02-09 00:00:00,3215,5663,75,8953,259
2021-02-10 00:00:00,3920,6949,71,10940,260
2021-02-11 00:00:00,3683,7386,73,11142,261
2021-02-12 00:00:00,2622,4638,36,7296,262
2021-02-13 00:00:00,1187,2565,4,3756,263
2021-02-14 00:00:00,1255,2208,5,3468,264
2021-02-15 00:00:00,1091,1550,18,2659,265
2021-02-16 00:00:00,1212,2187,7,3406,266
2021-02-17 00:00:00,637,1381,6,2024,267
2021-02-18 00:00:00,746,1418,4,2168,268
2021-02-19 00:00:00,3767,8091,55,11913,269
2021-02-20 00:00:00,3284,5854,33,9171,270
2021-02-21 00:00:00,1949,2400,5,4354,271
2021-02-22 00:00:00,2144,3982,19,6145,272
2021-02-23 00:00:00,3484,5479,30,8993,273
2021-02-24 00:00:00,3837,5868,22,9727,274
2021-02-25 00:00:00,3078,6052,33,9163,275
2021-02-26 00:00:00,3553,5450,28,9031,276
2021-02-27 00:00:00,2283,4440,12,6735,277
2021-02-28 00:00:00,1240,2394,4,3638,278
2021-03-01 00:00:00,1824,2946,13,4783,279
2021-03-02 00:00:00,2966,5190,30,8186,280
2021-03-03 00:00:00,3096,5996,20,9112,281
2021-03-04 00:00:00,3091,6266,23,9380,282
2021-03-05 00:00:00,3104,5083,44,8231,283
2021-03-06 00:00:00,2207,4377,27,6611,284
2021-03-07 00:00:00,1348,2231,0,3579,285
2021-03-08 00:00:00,1979,3060,9,5048,286
2021-03-09 00:00:00,2692,5339,8,8039,287
2021-03-10 00:00:00,2870,5175,25,8070,288
2021-03-11 00:00:00,2191,4040,16,6247,289
2021-03-12 00:00:00,1921,3393,14,5328,290
2021-03-13 00:00:00,2287,4122,7,6416,291
2021-03-14 00:00:00,1274,2631,6,3911,292
2021-03-15 00:00:00,1691,3184,15,4890,293
2021-03-16 00:00:00,2842,6081,39,8962,294
2021-03-17 00:00:00,3593,7174,54,10821,295
2021-03-18 00:00:00,3043,6074,50,9167,296
2021-03-19 00:00:00,2910,6455,97,9462,297
2021-03-20 00:00:00,2465,5620,54,8139,298
2021-03-21 00:00:00,1023,2062,16,3101,299
2021-03-22 00:00:00,1650,3216,31,4897,300
2021-03-23 00:00:00,2937,5794,58,8789,301
2021-03-24 00:00:00,2796,5527,31,8354,302
2021-03-25 00:00:00,2199,5336,17,7552,303
2021-03-26 00:00:00,2129,5822,13,7964,304
2021-03-27 00:00:00,1662,3918,19,5599,305
2021-03-28 00:00:00,1148,1991,4,3143,306
2021-03-29 00:00:00,1331,2832,5,4168,307
2021-03-30 00:00:00,2469,5829,12,8310,308
2021-03-31 00:00:00,2307,5913,12,8232,309
2021-04-01 00:00:00,2197,5136,18,7351,310
2021-04-02 00:00:00,1274,3041,17,4332,311
2021-04-03 00:00:00,885,2159,7,3051,312
2021-04-04 00:00:00,727,1558,3,2288,313
2021-04-05 00:00:00,1095,3013,4,4112,314
2021-04-06 00:00:00,2244,5554,12,7810,315
2021-04-07 00:00:00,2554,5791,17,8362,316
2021-04-08 00:00:00,1573,4168,8,5749,317
2021-04-09 00:00:00,1444,4607,4,6055,318
2021-04-10 00:00:00,1626,3498,15,5139,319
2021-04-11 00:00:00,927,2275,8,3210,320
2021-04-12 00:00:00,1405,3121,14,4540,321
2021-04-13 00:00:00,2172,4521,22,6715,322
2021-04-14 00:00:00,2189,4826,12,7027,323
2021-04-15 00:00:00,2823,5616,21,8460,324
2021-04-16 00:00:00,2079,3932,4,6015,325
2021-04-17 00:00:00,1766,3464,5,5235,326
2021-04-18 00:00:00,1014,1820,2,2836,327
2021-04-19 00:00:00,1562,2217,6,3785,328
2021-04-20 00:00:00,2506,4270,21,6797,329
2021-04-21 00:00:00,2389,4476,15,6880,330
2021-04-22 00:00:00,2640,4563,10,7213,331
2021-04-23 00:00:00,1872,3771,12,5655,332
2021-04-24 00:00:00,1709,3424,12,5145,333
2021-04-25 00:00:00,1010,1879,1,2890,334
2021-04-26 00:00:00,1771,2821,9,4601,335
2021-04-27 00:00:00,2370,4169,10,6549,336
2021-04-28 00:00:00,2148,3979,11,6138,337
2021-04-29 00:00:00,1967,4174,6,6147,338
2021-04-30 00:00:00,1844,3915,8,5767,339
2021-05-01 00:00:00,1182,2640,5,3827,340
2021-05-02 00:00:00,795,1368,0,2163,341
2021-05-03 00:00:00,1132,2256,3,3391,342
2021-05-04 00:00:00,1628,3445,4,5077,343
2021-05-05 00:00:00,1643,3898,19,5560,344
2021-05-06 00:00:00,1725,4234,25,5984,345
2021-05-07 00:00:00,1519,3612,16,5147,346
2021-05-08 00:00:00,1507,2932,9,4448,347
2021-05-09 00:00:00,776,1544,1,2321,348
2021-05-10 00:00:00,1158,2222,0,3380,349
2021-05-11 00:00:00,1761,3425,7,5193,350
2021-05-12 00:00:00,1433,2843,8,4284,351
2021-05-13 00:00:00,494,1263,0,1757,352
2021-05-14 00:00:00,216,660,0,876,353
2021-05-15 00:00:00,307,1186,1,1494,354
2021-05-16 00:00:00,613,1712,1,2326,355
2021-05-17 00:00:00,974,1821,9,2804,356
2021-05-18 00:00:00,1737,4655,10,6402,357
2021-05-19 00:00:00,1887,3726,17,5630,358
2021-05-20 00:00:00,2164,4287,12,6463,359
2021-05-21 00:00:00,2253,4141,10,6404,360
2021-05-22 00:00:00,1481,3036,3,4520,361
2021-05-23 00:00:00,990,2045,6,3041,362
2021-05-24 00:00:00,1675,3093,8,4776,363
2021-05-25 00:00:00,2303,4449,16,6768,364
2021-05-26 00:00:00,1830,3152,4,4986,365
2021-05-27 00:00:00,1628,2801,2,4431,366
2021-05-28 00:00:00,2956,4204,9,7169,367
2021-05-29 00:00:00,1707,3439,1,5147,368
2021-05-30 00:00:00,1180,2093,0,3273,369
2021-05-31 00:00:00,1163,2522,9,3694,370
2021-06-01 00:00:00,1607,2800,7,4414,371
2021-06-02 00:00:00,1453,2279,9,3741,372
2021-06-03 00:00:00,3284,4719,10,8013,373
2021-06-04 00:00:00,3240,4497,14,7751,374
2021-06-05 00:00:00,1823,3365,15,5203,375
2021-06-06 00:00:00,1068,1969,3,3040,376
2021-06-07 00:00:00,1701,2691,5,4397,377
2021-06-08 00:00:00,2687,4748,11,7446,378
2021-06-09 00:00:00,2698,4747,4,7449,379
2021-06-10 00:00:00,2940,4457,12,7409,380
2021-06-11 00:00:00,3472,5008,19,8499,381
2021-06-12 00:00:00,2828,3600,2,6430,382
2021-06-13 00:00:00,1916,2237,9,4162,383
2021-06-14 00:00:00,2463,3214,9,5686,384
2021-06-15 00:00:00,4748,6011,12,10771,385
2021-06-16 00:00:00,4793,5394,19,10206,386
2021-06-17 00:00:00,5323,5274,23,10620,387
2021-06-18 00:00:00,5380,4968,15,10363,388
2021-06-19 00:00:00,4196,4045,9,8250,389
2021-06-20 00:00:00,3416,2804,6,6226,390
2021-06-21 00:00:00,3077,2524,3,5604,391
2021-06-22 00:00:00,5966,5784,23,11773,392
2021-06-23 00:00:00,6615,6382,11,13008,393
2021-06-24 00:00:00,5975,5495,16,11486,394
2021-06-25 00:00:00,6177,5566,27,11770,395
2021-06-26 00:00:00,4908,4589,25,9522,396
2021-06-27 00:00:00,5068,3754,15,8837,397
2021-06-28 00:00:00,4735,3483,5,8223,398
2021-06-29 00:00:00,7780,5709,32,13521,399
2021-06-30 00:00:00,8797,7324,49,16170,400
2021-07-01 00:00:00,7576,6436,29,14041,401
2021-07-02 00:00:00,9256,7317,44,16617,402
2021-07-03 00:00:00,7499,6260,36,13795,403
2021-07-04 00:00:00,5395,4477,17,9889,404
2021-07-05 00:00:00,6261,4018,21,10300,405
2021-07-06 00:00:00,10345,8439,56,18840,406
2021-07-07 00:00:00,10546,9061,64,19671,407
2021-07-08 00:00:00,12921,9269,74,22264,408
2021-07-09 00:00:00,13168,10795,62,24025,409
2021-07-10 00:00:00,11692,8786,54,20532,410
2021-07-11 00:00:00,7162,5651,53,12866,411
2021-07-12 00:00:00,7993,6612,35,14640,412
2021-07-13 00:00:00,12721,11824,52,24597,413
2021-07-14 00:00:00,12511,11937,111,24559,414
2021-07-15 00:00:00,13218,14969,68,28255,415
2021-07-16 00:00:00,12036,13816,79,25931,416
2021-07-17 00:00:00,11718,13493,80,25291,417
2021-07-18 00:00:00,7554,8907,47,16508,418
2021-07-19 00:00:00,5361,7084,62,12507,419
2021-07-20 00:00:00,8806,9905,80,18791,420
2021-07-21 00:00:00,5353,7066,35,12454,421
2021-07-22 00:00:00,11614,13210,72,24896,422
2021-07-23 00:00:00,10786,12180,97,23063,423
2021-07-24 00:00:00,8704,11064,64,19832,424
2021-07-25 00:00:00,5521,7559,37,13117,425
2021-07-26 00:00:00,4427,5738,27,10192,426
2021-07-27 00:00:00,9027,11077,68,20172,427
2021-07-28 00:00:00,8876,10856,74,19806,428
2021-07-29 00:00:00,8232,11103,78,19413,429
2021-07-30 00:00:00,8067,10947,85,19099,430
2021-07-31 00:00:00,6292,9873,80,16245,431
2021-08-01 00:00:00,3894,6858,27,10779,432
2021-08-02 00:00:00,2916,4958,17,7891,433
2021-08-03 00:00:00,6668,10418,123,17209,434
2021-08-04 00:00:00,5835,10522,55,16412,435
2021-08-05 00:00:00,5696,11054,66,16816,436
2021-08-06 00:00:00,4192,9733,31,13956,437
2021-08-07 00:00:00,4446,10429,28,14903,438
2021-08-08 00:00:00,2383,6714,18,9115,439
2021-08-09 00:00:00,2058,4912,24,6994,440
2021-08-10 00:00:00,3773,8840,39,12652,441
2021-08-11 00:00:00,3072,7145,30,10247,442
2021-08-12 00:00:00,1643,4397,10,6050,443
2021-08-13 00:00:00,3272,8072,21,11365,444
2021-08-14 00:00:00,2584,8315,19,10918,445
2021-08-15 00:00:00,1296,5157,21,6474,446
2021-08-16 00:00:00,1128,4375,8,5511,447
2021-08-17 00:00:00,2343,6987,13,9343,448
2021-08-18 00:00:00,1177,4441,6,5624,449
2021-08-19 00:00:00,2933,8498,29,11460,450
2021-08-20 00:00:00,2878,7518,7,10403,451
2021-08-21 00:00:00,2037,7674,7,9718,452
2021-08-22 00:00:00,1415,7315,32,8762,453
2021-08-23 00:00:00,1139,5368,47,6554,454
2021-08-24 00:00:00,2180,8468,78,10726,455
2021-08-25 00:00:00,1977,7904,46,9927,456
2021-08-26 00:00:00,1750,7514,9,9273,457
2021-08-27 00:00:00,1444,8241,18,9703,458
2021-08-28 00:00:00,1176,7715,8,8899,459
2021-08-29 00:00:00,693,6313,5,7011,460
2021-08-30 00:00:00,664,4744,2,5410,461
2021-08-31 00:00:00,1573,9662,15,11250,462
2021-09-01 00:00:00,1425,7777,13,9215,463
2021-09-02 00:00:00,1065,7188,4,8257,464
2021-09-03 00:00:00,768,7255,7,8030,465
2021-09-04 00:00:00,767,7388,9,8164,466
2021-09-05 00:00:00,487,6522,5,7014,467
2021-09-06 00:00:00,369,5740,3,6112,468
2021-09-07 00:00:00,937,7881,2,8820,469
2021-09-08 00:00:00,718,6961,5,7684,470
2021-09-09 00:00:00,620,7160,8,7788,471
2021-09-10 00:00:00,660,7397,3,8060,472
2021-09-11 00:00:00,643,7736,7,8386,473
2021-09-12 00:00:00,400,7630,3,8033,474
2021-09-13 00:00:00,206,5438,0,5644,475
2021-09-14 00:00:00,418,7319,3,7740,476
2021-09-15 00:00:00,405,8047,3,8455,477
2021-09-16 00:00:00,394,7665,2,8061,478
2021-09-17 00:00:00,334,7275,10,7619,479
2021-09-18 00:00:00,288,7706,5,7999,480
2021-09-19 00:00:00,201,6907,1,7109,481
2021-09-20 00:00:00,145,5956,5,6106,482
2021-09-21 00:00:00,297,7868,3,8168,483
2021-09-22 00:00:00,215,7776,7,7998,484
2021-09-23 00:00:00,245,6651,2,6898,485
2021-09-24 00:00:00,237,6906,4,7147,486
2021-09-25 00:00:00,202,7367,6,7575,487
2021-09-26 00:00:00,133,7060,2,7195,488
2021-09-27 00:00:00,136,4963,0,5099,489
2021-09-28 00:00:00,181,7416,1,7598,490
2021-09-29 00:00:00,221,7734,3,7958,491
2021-09-30 00:00:00,179,7485,4,7668,492
2021-10-01 00:00:00,159,6366,2,6527,493
2021-10-02 00:00:00,190,6475,1,6666,494
2021-10-03 00:00:00,114,6884,2,7000,495
2021-10-04 00:00:00,84,6114,0,6198,496
2021-10-05 00:00:00,150,7443,2,7595,497
2021-10-06 00:00:00,121,7955,0,8076,498
2021-10-07 00:00:00,139,6889,1,7029,499
2021-10-08 00:00:00,109,6861,3,6973,500
2021-10-09 00:00:00,130,7273,2,7405,501
2021-10-10 00:00:00,63,7574,1,7638,502
2021-10-11 00:00:00,56,4970,1,5027,503
2021-10-12 00:00:00,99,7944,0,8043,504
2021-10-13 00:00:00,101,7147,1,7249,505
2021-10-14 00:00:00,104,7869,1,7974,506
2021-10-15 00:00:00,100,8084,0,8184,507
2021-10-16 00:00:00,92,7863,0,7955,508
2021-10-17 00:00:00,67,7597,2,7666,509
2021-10-18 00:00:00,46,5958,0,6004,510
2021-10-19 00:00:00,92,6947,2,7041,511
2021-10-20 00:00:00,152,11153,2,11307,512
2021-10-21 00:00:00,56,7466,3,7525,513
2021-10-22 00:00:00,108,9424,1,9533,514
2021-10-23 00:00:00,72,9589,1,9662,515
2021-10-24 00:00:00,115,11631,0,11746,516
2021-10-25 00:00:00,77,7691,3,7771,517
2021-10-26 00:00:00,139,10868,1,11008,518
2021-10-27 00:00:00,120,11094,2,11216,519
2021-10-28 00:00:00,138,11225,0,11363,520
2021-10-29 00:00:00,202,9294,3,9499,521
2021-10-30 00:00:00,162,9874,2,10038,522
2021-10-31 00:00:00,117,10876,8,11001,523
2021-11-01 00:00:00,46,8250,1,8297,524
2021-11-02 00:00:00,69,9686,4,9759,525
2021-11-03 00:00:00,186,10874,3,11063,526
2021-11-04 00:00:00,158,7753,4,7915,527
2021-11-05 00:00:00,124,7194,2,7320,528
2021-11-06 00:00:00,60,6424,1,6485,529
2021-11-07 00:00:00,102,5915,0,6017,530
2021-11-08 00:00:00,20,4781,0,4801,531
2021-11-09 00:00:00,79,7247,3,7329,532
2021-11-10 00:00:00,79,7660,0,7739,533
2021-11-11 00:00:00,43,6276,1,6320,534
2021-11-12 00:00:00,56,5037,1,5094,535
2021-11-13 00:00:00,59,5798,0,5857,536
2021-11-14 00:00:00,39,5147,0,5186,537
2021-11-15 00:00:00,38,4227,1,4266,538
2021-11-16 00:00:00,83,7480,0,7563,539
2021-11-17 00:00:00,190,7790,1,7981,540
2021-11-18 00:00:00,63,6695,0,6758,541
2021-11-19 00:00:00,69,6398,1,6468,542
2021-11-20 00:00:00,58,5939,3,6000,543
2021-11-21 00:00:00,28,5033,1,5062,544
2021-11-22 00:00:00,32,4418,1,4451,545
2021-11-23 00:00:00,83,6713,2,6798,546
2021-11-24 00:00:00,87,5911,0,5998,547
2021-11-25 00:00:00,48,5934,1,5983,548
2021-11-26 00:00:00,96,8116,0,8212,549
2021-11-27 00:00:00,52,6355,0,6407,550
2021-11-28 00:00:00,34,4347,0,4381,551
2021-11-29 00:00:00,37,4462,0,4499,552
2021-11-30 00:00:00,58,6148,1,6207,553
2021-12-01 00:00:00,59,6069,1,6129,554
2021-12-02 00:00:00,100,6404,0,6504,555
2021-12-03 00:00:00,44,5470,2,5516,556
2021-12-04 00:00:00,64,5965,0,6029,557
2021-12-05 00:00:00,30,4757,0,4787,558
2021-12-06 00:00:00,28,4284,0,4312,559
2021-12-07 00:00:00,55,6047,0,6102,560
2021-12-08 00:00:00,75,5212,0,5287,561
2021-12-09 00:00:00,53,5559,2,5614,562
2021-12-10 00:00:00,46,6061,0,6107,563
2021-12-11 00:00:00,55,5227,1,5283,564
2021-12-12 00:00:00,27,5081,1,5109,565
2021-12-13 00:00:00,22,3878,0,3900,566
2021-12-14 00:00:00,44,6562,2,6608,567
2021-12-15 00:00:00,65,6460,1,6526,568
2021-12-16 00:00:00,33,6965,1,6999,569
2021-12-17 00:00:00,52,7146,1,7199,570
2021-12-18 00:00:00,53,6617,1,6671,571
2021-12-19 00:00:00,26,6348,1,6375,572
2021-12-20 00:00:00,30,4527,0,4557,573
2021-12-21 00:00:00,33,7653,1,7687,574
2021-12-22 00:00:00,42,7079,0,7121,575
2021-12-23 00:00:00,24,7834,2,7860,576
2021-12-24 00:00:00,25,6885,0,6910,577
2021-12-25 00:00:00,31,5845,0,5876,578
2021-12-26 00:00:00,21,3774,0,3795,579
2021-12-27 00:00:00,32,3819,0,3851,580
2021-12-28 00:00:00,28,6908,1,6937,581
2021-12-29 00:00:00,57,5938,1,5996,582
2021-12-30 00:00:00,21,4984,1,5006,583
2021-12-31 00:00:00,22,4310,1,4333,584
2022-01-01 00:00:00,26,3698,0,3724,585
2022-01-02 00:00:00,16,3038,0,3054,586
2022-01-03 00:00:00,59,3764,1,3824,587
2022-01-04 00:00:00,38,6691,0,6729,588
2022-01-05 00:00:00,30,6463,1,6494,589
2022-01-06 00:00:00,57,4628,1,4686,590
2022-01-07 00:00:00,81,5604,3,5688,591
2022-01-08 00:00:00,79,5278,1,5358,592
2022-01-09 00:00:00,117,4841,2,4960,593
2022-01-10 00:00:00,55,4038,1,4094,594
2022-01-11 00:00:00,83,4774,0,4857,595
2022-01-12 00:00:00,78,4309,1,4388,596
2022-01-13 00:00:00,114,5894,0,6008,597
2022-01-14 00:00:00,214,5590,3,5807,598
2022-01-15 00:00:00,138,4527,1,4666,599
2022-01-16 00:00:00,141,4654,3,4798,600
2022-01-17 00:00:00,116,4448,1,4565,601
2022-01-18 00:00:00,260,6198,6,6464,602
2022-01-19 00:00:00,308,6186,2,6496,603
2022-01-20 00:00:00,373,5658,0,6031,604
2022-01-21 00:00:00,397,5802,1,6200,605
2022-01-22 00:00:00,508,6726,1,7235,606
2022-01-23 00:00:00,563,5782,0,6345,607
2022-01-24 00:00:00,329,4505,0,4834,608
2022-01-25 00:00:00,1057,7283,7,8347,609
2022-01-26 00:00:00,1323,8548,3,9874,610
2022-01-27 00:00:00,1554,9985,4,11543,611
2022-01-28 00:00:00,2243,10391,14,12648,612
2022-01-29 00:00:00,2428,12112,12,14552,613
2022-01-30 00:00:00,2422,9419,2,11843,614
2022-01-31 00:00:00,1813,5365,0,7178,615
2022-02-01 00:00:00,3762,11767,11,15540,616
2022-02-02 00:00:00,3209,10395,2,13606,617
2022-02-03 00:00:00,6877,14005,6,20888,618
2022-02-04 00:00:00,6473,15345,9,21827,619
2022-02-05 00:00:00,7518,16285,10,23813,620
2022-02-06 00:00:00,6821,13744,21,20586,621
2022-02-07 00:00:00,5575,11614,4,17193,622
2022-02-08 00:00:00,9106,15863,8,24977,623
2022-02-09 00:00:00,11978,17714,21,29713,624
2022-02-10 00:00:00,9453,13152,19,22624,625
2022-02-11 00:00:00,9550,12272,23,21845,626
2022-02-12 00:00:00,13389,19590,21,33000,627
2022-02-13 00:00:00,10427,14128,26,24581,628
2022-02-14 00:00:00,8523,11325,17,19865,629
2022-02-15 00:00:00,12685,15681,17,28383,630
2022-02-16 00:00:00,14766,18703,11,33480,631
2022-02-17 00:00:00,14819,17705,32,32556,632
2022-02-18 00:00:00,13093,17501,40,30634,633
2022-02-19 00:00:00,12053,16066,14,28133,634
2022-02-20 00:00:00,11245,17394,22,28661,635
2022-02-21 00:00:00,7880,13129,8,21017,636
2022-02-22 00:00:00,11421,17139,19,28579,637
2022-02-23 00:00:00,12030,17483,13,29526,638
2022-02-24 00:00:00,11033,15327,21,26381,639
2022-02-25 00:00:00,9795,13958,22,23775,640
2022-02-26 00:00:00,9095,14406,34,23535,641
2022-02-27 00:00:00,6689,12967,31,19687,642
2022-02-28 00:00:00,4322,9684,1,14007,643
2022-03-01 00:00:00,5356,10425,5,15786,644
2022-03-02 00:00:00,8717,14164,17,22898,645
2022-03-03 00:00:00,8279,14172,28,22479,646
2022-03-04 00:00:00,5405,9415,17,14837,647
2022-03-05 00:00:00,6630,10997,16,17643,648
2022-03-06 00:00:00,6062,11062,30,17154,649
2022-03-07 00:00:00,4327,7655,3,11985,650
2022-03-08 00:00:00,7597,11482,26,19105,651
2022-03-09 00:00:00,5932,10359,35,16326,652
2022-03-10 00:00:00,5436,9345,49,14830,653
2022-03-11 00:00:00,4911,7733,31,12675,654
2022-03-12 00:00:00,3806,7566,32,11404,655
2022-03-13 00:00:00,3044,5983,27,9054,656
2022-03-14 00:00:00,1995,6120,13,8128,657
2022-03-15 00:00:00,3713,7647,12,11372,658
2022-03-16 00:00:00,3101,6988,22,10111,659
2022-03-17 00:00:00,2805,6907,11,9723,660
2022-03-18 00:00:00,2568,6502,14,9084,661
2022-03-19 00:00:00,2084,5155,13,7252,662
2022-03-20 00:00:00,1594,4901,4,6499,663
2022-03-21 00:00:00,1072,3670,2,4744,664
2022-03-22 00:00:00,2072,6961,8,9041,665
2022-03-23 00:00:00,1559,5574,13,7146,666
2022-03-24 00:00:00,1384,5363,9,6756,667
2022-03-25 00:00:00,1380,4934,11,6325,668
2022-03-26 00:00:00,1066,4900,7,5973,669
2022-03-27 00:00:00,930,3933,2,4865,670
2022-03-28 00:00:00,647,3328,5,3980,671
2022-03-29 00:00:00,1069,4478,6,5553,672
2022-03-30 00:00:00,1013,4251,12,5276,673
2022-03-31 00:00:00,804,4255,10,5069,674
2022-04-01 00:00:00,799,4488,2,5289,675
2022-04-02 00:00:00,548,3175,9,3732,676
2022-04-03 00:00:00,452,3165,3,3620,677
2022-04-04 00:00:00,351,2635,1,2987,678
2022-04-05 00:00:00,548,3743,5,4296,679
2022-04-06 00:00:00,510,3623,6,4139,680
2022-04-07 00:00:00,396,3418,1,3815,681
2022-04-08 00:00:00,359,2988,0,3347,682
2022-04-09 00:00:00,281,2357,0,2638,683
2022-04-10 00:00:00,240,2666,4,2910,684
2022-04-11 00:00:00,304,2477,0,2781,685
2022-04-12 00:00:00,341,3346,2,3689,686
2022-04-13 00:00:00,301,3810,4,4115,687
2022-04-14 00:00:00,292,4021,0,4313,688
2022-04-15 00:00:00,223,3159,0,3382,689
2022-04-16 00:00:00,116,2812,0,2928,690
2022-04-17 00:00:00,133,3842,0,3975,691
2022-04-18 00:00:00,143,2250,2,2395,692
2022-04-19 00:00:00,211,3355,1,3567,693
2022-04-20 00:00:00,171,3638,0,3809,694
2022-04-21 00:00:00,196,3477,4,3677,695
2022-04-22 00:00:00,140,2879,1,3020,696
2022-04-23 00:00:00,96,3168,1,3265,697
2022-04-24 00:00:00,79,2797,0,2876,698
2022-04-25 00:00:00,80,2548,2,2630,699
2022-04-26 00:00:00,122,3152,0,3274,700
2022-04-27 00:00:00,87,3481,2,3570,701
2022-04-28 00:00:00,77,2694,1,2772,702
2022-04-29 00:00:00,110,2874,0,2984,703
2022-04-30 00:00:00,50,2030,1,2081,704
2022-05-01 00:00:00,57,1281,0,1338,705
2022-05-02 00:00:00,22,988,0,1010,706
2022-05-03 00:00:00,20,759,0,779,707
2022-05-04 00:00:00,31,1349,0,1380,708
2022-05-05 00:00:00,66,2305,3,2374,709
2022-05-06 00:00:00,35,2507,0,2542,710
2022-05-07 00:00:00,33,2659,1,2693,711
2022-05-08 00:00:00,45,3732,0,3777,712
2022-05-09 00:00:00,39,4371,0,4410,713
2022-05-10 00:00:00,95,4568,1,4664,714
2022-05-11 00:00:00,70,3551,0,3621,715
2022-05-12 00:00:00,52,2789,1,2842,716
2022-05-13 00:00:00,60,2939,3,3002,717
2022-05-14 00:00:00,36,3214,0,3250,718
2022-05-15 00:00:00,39,2555,0,2594,719
2022-05-16 00:00:00,16,1980,0,1996,720
2022-05-17 00:00:00,34,2846,0,2880,721
2022-05-18 00:00:00,69,2945,0,3014,722
2022-05-19 00:00:00,58,2974,1,3033,723
2022-05-20 00:00:00,42,2321,0,2363,724
2022-05-21 00:00:00,34,1783,0,1817,725
2022-05-22 00:00:00,24,1606,0,1630,726
2022-05-23 00:00:00,28,1410,0,1438,727
2022-05-24 00:00:00,58,2796,1,2855,728
2022-05-25 00:00:00,46,2925,0,2971,729
2022-05-26 00:00:00,23,2579,1,2603,730
2022-05-27 00:00:00,23,2028,0,2051,731
2022-05-28 00:00:00,58,1944,1,2003,732
2022-05-29 00:00:00,46,1631,1,1678,733
2022-05-30 00:00:00,46,1604,3,1653,734
2022-05-31 00:00:00,83,2779,2,2864,735
2022-06-01 00:00:00,50,2230,0,2280,736
2022-06-02 00:00:00,33,1643,0,1676,737
2022-06-03 00:00:00,53,2634,1,2688,738
2022-06-04 00:00:00,56,3004,0,3060,739
2022-06-05 00:00:00,61,1933,0,1994,740
2022-06-06 00:00:00,50,1944,0,1994,741
2022-06-07 00:00:00,81,2433,0,2514,742
2022-06-08 00:00:00,82,2180,0,2262,743
2022-06-09 00:00:00,73,2791,0,2864,744
2022-06-10 00:00:00,96,2158,1,2255,745
2022-06-11 00:00:00,72,1876,0,1948,746
2022-06-12 00:00:00,61,2828,0,2889,747
2022-06-13 00:00:00,63,3047,1,3111,748
2022-06-14 00:00:00,135,2767,0,2902,749
2022-06-15 00:00:00,203,4055,0,4258,750
2022-06-16 00:00:00,143,3366,0,3509,751
2022-06-17 00:00:00,176,3025,0,3201,752
2022-06-18 00:00:00,173,2432,0,2605,753
2022-06-19 00:00:00,140,1771,2,1913,754
2022-06-20 00:00:00,160,2243,1,2404,755
2022-06-21 00:00:00,256,3027,0,3283,756
2022-06-22 00:00:00,258,3364,2,3624,757
2022-06-23 00:00:00,323,2836,2,3161,758
2022-06-24 00:00:00,315,3174,1,3490,759
2022-06-25 00:00:00,270,3019,2,3291,760
2022-06-26 00:00:00,261,2222,0,2483,761
2022-06-27 00:00:00,220,2198,1,2419,762
2022-06-28 00:00:00,364,4076,0,4440,763
2022-06-29 00:00:00,352,3064,3,3419,764
2022-06-30 00:00:00,369,3732,2,4103,765
2022-07-01 00:00:00,384,3187,0,3571,766
2022-07-02 00:00:00,342,2304,1,2647,767
2022-07-03 00:00:00,306,1864,3,2173,768
2022-07-04 00:00:00,252,1635,0,1887,769
2022-07-05 00:00:00,488,3045,0,3533,770
2022-07-06 00:00:00,488,3359,0,3847,771
2022-07-07 00:00:00,543,2752,0,3295,772
2022-07-08 00:00:00,474,2823,1,3298,773
2022-07-09 00:00:00,489,2519,6,3014,774
2022-07-10 00:00:00,318,1335,0,1653,775
2022-07-11 00:00:00,243,2130,1,2374,776
2022-07-12 00:00:00,685,3577,1,4263,777
2022-07-13 00:00:00,606,2975,0,3581,778
2022-07-14 00:00:00,592,2894,0,3486,779
2022-07-15 00:00:00,592,2744,1,3337,780
2022-07-16 00:00:00,830,2757,1,3588,781
2022-07-17 00:00:00,499,3012,1,3512,782
2022-07-18 00:00:00,542,2131,1,2674,783
2022-07-19 00:00:00,926,3139,0,4065,784
2022-07-20 00:00:00,957,3299,1,4257,785
2022-07-21 00:00:00,852,3418,3,4273,786
2022-07-22 00:00:00,879,3037,2,3918,787
2022-07-23 00:00:00,857,3276,3,4136,788
2022-07-24 00:00:00,674,2354,4,3032,789
2022-07-25 00:00:00,639,2022,0,2661,790
2022-07-26 00:00:00,1196,4371,3,5570,791
2022-07-27 00:00:00,1174,4160,1,5335,792
2022-07-28 00:00:00,1125,3850,2,4977,793
2022-07-29 00:00:00,1029,3863,4,4896,794
2022-07-30 00:00:00,1022,4126,4,5152,795
2022-07-31 00:00:00,660,1741,0,2401,796
2022-08-01 00:00:00,821,2411,1,3233,797
2022-08-02 00:00:00,1505,3925,2,5432,798
2022-08-03 00:00:00,1309,2904,2,4215,799
2022-08-04 00:00:00,1470,3880,3,5353,800
2022-08-05 00:00:00,1134,3674,1,4809,801
2022-08-06 00:00:00,1240,3730,2,4972,802
2022-08-07 00:00:00,813,2655,1,3469,803
2022-08-08 00:00:00,894,2573,0,3467,804
2022-08-09 00:00:00,1586,4541,3,6130,805
2022-08-10 00:00:00,1429,3778,0,5207,806
2022-08-11 00:00:00,1284,3710,1,4995,807
2022-08-12 00:00:00,1243,4068,0,5311,808
2022-08-13 00:00:00,1183,3119,2,4304,809
2022-08-14 00:00:00,890,2325,6,3221,810
2022-08-15 00:00:00,711,2050,1,2762,811
2022-08-16 00:00:00,1253,3157,3,4413,812
2022-08-17 00:00:00,1122,3385,1,4508,813
2022-08-18 00:00:00,740,2605,0,3345,814
2022-08-19 00:00:00,1074,3549,3,4626,815
2022-08-20 00:00:00,1026,2941,0,3967,816
2022-08-21 00:00:00,795,2309,0,3104,817
2022-08-22 00:00:00,764,2264,2,3030,818
2022-08-23 00:00:00,1151,3870,5,5026,819
2022-08-24 00:00:00,1029,3375,0,4404,820
2022-08-25 00:00:00,1072,4125,3,5200,821
2022-08-26 00:00:00,964,3286,0,4250,822
2022-08-27 00:00:00,877,3421,1,4299,823
2022-08-28 00:00:00,742,2804,5,3551,824
2022-08-29 00:00:00,621,1917,0,2538,825
2022-08-30 00:00:00,1541,4001,5,5547,826
2022-08-31 00:00:00,980,2889,0,3869,827
2022-09-01 00:00:00,783,2992,1,3776,828
2022-09-02 00:00:00,697,2722,2,3421,829
2022-09-03 00:00:00,723,2390,1,3114,830
2022-09-04 00:00:00,526,1881,1,2408,831
2022-09-05 00:00:00,474,2586,0,3060,832
2022-09-06 00:00:00,746,2611,0,3357,833
2022-09-07 00:00:00,743,2593,1,3337,834
2022-09-08 00:00:00,575,2517,0,3092,835
2022-09-09 00:00:00,495,1985,1,2481,836
2022-09-10 00:00:00,486,1893,1,2380,837
2022-09-11 00:00:00,398,1526,2,1926,838
2022-09-12 00:00:00,313,1222,0,1535,839
2022-09-13 00:00:00,636,2422,1,3059,840
2022-09-14 00:00:00,497,2073,0,2570,841
2022-09-15 00:00:00,487,2260,2,2749,842
2022-09-16 00:00:00,454,2104,0,2558,843
2022-09-17 00:00:00,450,1712,2,2164,844
2022-09-18 00:00:00,303,1420,1,1724,845
2022-09-19 00:00:00,319,1585,0,1904,846
2022-09-20 00:00:00,470,2712,0,3182,847
2022-09-21 00:00:00,425,2652,2,3079,848
2022-09-22 00:00:00,378,2228,0,2606,849
2022-09-23 00:00:00,396,1894,1,2291,850
2022-09-24 00:00:00,364,1807,0,2171,851
2022-09-25 00:00:00,253,1263,5,1521,852
2022-09-26 00:00:00,236,1443,0,1679,853
2022-09-27 00:00:00,378,2389,2,2769,854
2022-09-28 00:00:00,336,2324,1,2661,855
2022-09-29 00:00:00,361,2318,1,2680,856
2022-09-30 00:00:00,315,2062,1,2378,857
2022-10-01 00:00:00,359,2135,2,2496,858
2022-10-02 00:00:00,234,1496,1,1731,859
2022-10-03 00:00:00,234,1315,0,1549,860
2022-10-04 00:00:00,363,2016,2,2381,861
2022-10-05 00:00:00,300,1860,0,2160,862
2022-10-06 00:00:00,341,1708,0,2049,863
2022-10-07 00:00:00,255,1751,1,2007,864
2022-10-08 00:00:00,250,1430,0,1680,865
2022-10-09 00:00:00,178,992,0,1170,866
2022-10-10 00:00:00,233,1355,0,1588,867
2022-10-11 00:00:00,340,1915,1,2256,868
2022-10-12 00:00:00,308,2146,2,2456,869
2022-10-13 00:00:00,292,1801,0,2093,870
2022-10-14 00:00:00,251,1670,0,1921,871
2022-10-15 00:00:00,273,1264,1,1538,872
2022-10-16 00:00:00,224,1173,0,1397,873
2022-10-17 00:00:00,184,1411,1,1596,874
2022-10-18 00:00:00,342,1842,1,2185,875
2022-10-19 00:00:00,311,1954,0,2265,876
2022-10-20 00:00:00,310,2051,3,2364,877
2022-10-21 00:00:00,294,1749,0,2043,878
2022-10-22 00:00:00,288,1474,1,1763,879
2022-10-23 00:00:00,209,1153,0,1362,880
2022-10-24 00:00:00,273,1622,0,1895,881
2022-10-25 00:00:00,469,2340,5,2814,882
2022-10-26 00:00:00,446,1992,0,2438,883
2022-10-27 00:00:00,367,1914,2,2283,884
2022-10-28 00:00:00,416,1880,3,2299,885
2022-10-29 00:00:00,374,1776,2,2152,886
2022-10-30 00:00:00,360,1575,0,1935,887
2022-10-31 00:00:00,323,1811,0,2134,888
2022-11-01 00:00:00,593,2357,2,2952,889
2022-11-02 00:00:00,632,2335,2,2969,890
2022-11-03 00:00:00,594,2124,1,2719,891
2022-11-04 00:00:00,636,2024,2,2662,892
2022-11-05 00:00:00,624,1610,0,2234,893
2022-11-06 00:00:00,499,1989,0,2488,894
2022-11-07 00:00:00,556,1731,1,2288,895
2022-11-08 00:00:00,846,1884,0,2730,896
2022-11-09 00:00:00,715,2065,0,2780,897
2022-11-10 00:00:00,846,1968,2,2816,898
2022-11-11 00:00:00,826,1760,0,2586,899
2022-11-12 00:00:00,844,1962,1,2807,900
2022-11-13 00:00:00,683,2164,0,2847,901
2022-11-14 00:00:00,666,2388,0,3054,902
2022-11-15 00:00:00,1301,2799,0,4100,903
2022-11-16 00:00:00,1283,2652,0,3935,904
2022-11-17 00:00:00,1127,2331,1,3459,905
2022-11-18 00:00:00,1073,2048,1,3122,906
2022-11-19 00:00:00,1017,1882,0,2899,907
2022-11-20 00:00:00,803,1364,1,2168,908
2022-11-21 00:00:00,737,1666,0,2403,909
2022-11-22 00:00:00,1456,2813,1,4270,910
2022-11-23 00:00:00,1177,2123,2,3302,911
2022-11-24 00:00:00,1343,2480,1,3824,912
2022-11-25 00:00:00,1136,2051,2,3189,913
2022-11-26 00:00:00,974,1764,4,2742,914
2022-11-27 00:00:00,845,1576,0,2421,915
2022-11-28 00:00:00,676,1727,0,2403,916
2022-11-29 00:00:00,1237,2840,2,4079,917
2022-11-30 00:00:00,1105,2780,2,3887,918
2022-12-01 00:00:00,1015,2471,1,3487,919
2022-12-02 00:00:00,892,2645,2,3539,920
2022-12-03 00:00:00,810,1791,1,2602,921
2022-12-04 00:00:00,618,1435,2,2055,922
2022-12-05 00:00:00,557,1379,0,1936,923
2022-12-06 00:00:00,891,2038,0,2929,924
2022-12-07 00:00:00,775,1684,2,2461,925
2022-12-08 00:00:00,774,1597,1,2372,926
2022-12-09 00:00:00,628,1911,0,2539,927
2022-12-10 00:00:00,593,1432,1,2026,928
2022-12-11 00:00:00,445,1419,3,1867,929
2022-12-12 00:00:00,315,1117,0,1432,930
2022-12-13 00:00:00,585,1781,2,2368,931
2022-12-14 00:00:00,550,1890,1,2441,932
2022-12-15 00:00:00,500,1343,0,1843,933
2022-12-16 00:00:00,372,1600,0,1972,934
2022-12-17 00:00:00,364,1363,3,1730,935
2022-12-18 00:00:00,284,1060,2,1346,936
2022-12-19 00:00:00,200,903,0,1103,937
2022-12-20 00:00:00,337,1598,0,1935,938
2022-12-21 00:00:00,269,1273,1,1543,939
2022-12-22 00:00:00,282,1966,1,2249,940
2022-12-23 00:00:00,275,1763,0,2038,941
2022-12-24 00:00:00,232,1176,1,1409,942
2022-12-25 00:00:00,150,751,3,904,943
2022-12-26 00:00:00,128,1186,1,1315,944
2022-12-27 00:00:00,237,1223,0,1460,945
2022-12-28 00:00:00,201,1312,1,1514,946
2022-12-29 00:00:00,190,1545,0,1735,947
2022-12-30 00:00:00,152,904,0,1056,948
2022-12-31 00:00:00,126,725,0,851,949
2023-01-01 00:00:00,104,756,1,861,950
2023-01-02 00:00:00,59,932,0,991,951
2023-01-03 00:00:00,192,1359,1,1552,952
2023-01-04 00:00:00,143,953,2,1098,953
2023-01-05 00:00:00,124,934,0,1058,954
2023-01-06 00:00:00,149,1177,0,1326,955
2023-01-07 00:00:00,120,892,1,1013,956
2023-01-08 00:00:00,89,762,0,851,957
2023-01-09 00:00:00,61,866,0,927,958
2023-01-10 00:00:00,127,1030,3,1160,959
2023-01-11 00:00:00,91,984,0,1075,960
2023-01-12 00:00:00,98,857,1,956,961
2023-01-13 00:00:00,90,933,0,1023,962
2023-01-14 00:00:00,101,776,0,877,963
2023-01-15 00:00:00,69,767,0,836,964
2023-01-16 00:00:00,65,646,0,711,965
2023-01-17 00:00:00,120,1055,1,1176,966
2023-01-18 00:00:00,79,984,0,1063,967
2023-01-19 00:00:00,77,979,1,1057,968
2023-01-20 00:00:00,70,715,0,785,969
2023-01-21 00:00:00,86,721,0,807,970
2023-01-22 00:00:00,52,527,1,580,971
2023-01-23 00:00:00,35,412,0,447,972
2023-01-24 00:00:00,52,724,0,776,973
2023-01-25 00:00:00,83,897,1,981,974
2023-01-26 00:00:00,68,1060,0,1128,975
2023-01-27 00:00:00,58,677,0,735,976
2023-01-28 00:00:00,52,549,1,602,977
2023-01-29 00:00:00,43,759,0,802,978
2023-01-30 00:00:00,35,550,0,585,979
2023-01-31 00:00:00,77,868,0,945,980
2023-02-01 00:00:00,56,945,0,1001,981
2023-02-02 00:00:00,51,689,0,740,982
2023-02-03 00:00:00,56,1735,1,1792,983
2023-02-04 00:00:00,46,891,0,937,984
2023-02-05 00:00:00,30,567,0,597,985
2023-02-06 00:00:00,38,446,0,484,986
2023-02-07 00:00:00,73,986,0,1059,987
2023-02-08 00:00:00,59,689,0,748,988
2023-02-09 00:00:00,51,703,0,754,989
2023-02-10 00:00:00,57,645,1,703,990
2023-02-11 00:00:00,55,591,0,646,991
2023-02-12 00:00:00,40,561,0,601,992
2023-02-13 00:00:00,31,560,0,591,993
2023-02-14 00:00:00,56,869,0,925,994
2023-02-15 00:00:00,59,738,1,798,995
2023-02-16 00:00:00,51,577,0,628,996
2023-02-17 00:00:00,47,453,0,500,997
2023-02-18 00:00:00,40,592,0,632,998
2023-02-19 00:00:00,32,370,0,402,999
2023-02-20 00:00:00,28,419,0,447,1000
2023-02-21 00:00:00,73,846,0,919,1001
2023-02-22 00:00:00,52,631,1,684,1002
2023-02-23 00:00:00,51,608,0,659,1003
2023-02-24 00:00:00,59,518,0,577,1004
2023-02-25 00:00:00,44,514,0,558,1005
2023-02-26 00:00:00,32,488,0,520,1006
2023-02-27 00:00:00,43,377,0,420,1007
2023-02-28 00:00:00,72,773,0,845,1008
2023-03-01 00:00:00,78,732,0,810,1009
2023-03-02 00:00:00,72,609,0,681,1010
2023-03-03 00:00:00,46,557,0,603,1011
2023-03-04 00:00:00,54,652,0,706,1012
2023-03-05 00:00:00,45,450,0,495,1013
2023-03-06 00:00:00,52,467,0,519,1014
2023-03-07 00:00:00,79,755,0,834,1015
2023-03-08 00:00:00,73,665,0,738,1016
2023-03-09 00:00:00,74,560,0,634,1017
2023-03-10 00:00:00,73,504,0,577,1018
2023-03-11 00:00:00,80,518,0,598,1019
2023-03-12 00:00:00,51,485,0,536,1020
2023-03-13 00:00:00,58,410,0,468,1021
2023-03-14 00:00:00,105,735,0,840,1022
2023-03-15 00:00:00,64,670,0,734,1023
2023-03-16 00:00:00,84,583,0,667,1024
2023-03-17 00:00:00,61,343,0,404,1025
2023-03-18 00:00:00,70,471,0,541,1026
2023-03-19 00:00:00,68,455,0,523,1027
2023-03-20 00:00:00,51,392,0,443,1028
2023-03-21 00:00:00,83,631,0,714,1029
2023-03-22 00:00:00,96,470,2,568,1030
2023-03-23 00:00:00,35,305,0,340,1031
2023-03-24 00:00:00,81,390,0,471,1032
2023-03-25 00:00:00,102,441,0,543,1033
2023-03-26 00:00:00,69,456,0,525,1034
2023-03-27 00:00:00,63,358,0,421,1035
2023-03-28 00:00:00,87,535,0,622,1036
2023-03-29 00:00:00,132,584,1,717,1037
2023-03-30 00:00:00,109,426,0,535,1038
2023-03-31 00:00:00,91,458,1,550,1039
2023-04-01 00:00:00,93,377,0,470,1040
2023-04-02 00:00:00,50,285,0,335,1041
2023-04-03 00:00:00,66,263,0,329,1042
2023-04-04 00:00:00,151,588,0,739,1043
2023-04-05 00:00:00,113,407,0,520,1044
2023-04-06 00:00:00,101,316,0,417,1045
2023-04-07 00:00:00,96,298,0,394,1046
2023-04-08 00:00:00,60,159,0,219,1047
2023-04-09 00:00:00,98,328,1,427,1048
2023-04-10 00:00:00,86,325,0,411,1049
2023-04-11 00:00:00,184,615,0,799,1050
2023-04-12 00:00:00,146,393,0,539,1051
2023-04-13 00:00:00,139,386,1,526,1052
2023-04-14 00:00:00,157,441,0,598,1053
2023-04-15 00:00:00,174,309,0,483,1054
2023-04-16 00:00:00,126,241,0,367,1055
2023-04-17 00:00:00,126,289,0,415,1056
2023-04-18 00:00:00,214,535,0,749,1057
2023-04-19 00:00:00,196,365,0,561,1058
2023-04-20 00:00:00,155,251,0,406,1059
2023-04-21 00:00:00,169,206,0,375,1060
2023-04-22 00:00:00,120,120,0,240,1061
2023-04-23 00:00:00,65,67,0,132,1062
2023-04-24 00:00:00,96,137,0,233,1063
2023-04-25 00:00:00,234,307,0,541,1064
2023-04-26 00:00:00,305,384,1,690,1065
2023-04-27 00:00:00,379,538,0,917,1066
2023-04-28 00:00:00,353,510,0,863,1067
2023-04-29 00:00:00,378,413,1,792,1068
2023-04-30 00:00:00,257,373,0,630,1069
2023-05-01 00:00:00,172,271,0,443,1070
2023-05-02 00:00:00,289,376,0,665,1071
2023-05-03 00:00:00,522,629,0,1151,1072
2023-05-04 00:00:00,395,616,0,1011,1073
2023-05-05 00:00:00,367,553,0,920,1074
2023-05-06 00:00:00,330,555,0,885,1075
2023-05-07 00:00:00,244,441,0,685,1076
2023-05-08 00:00:00,178,359,0,537,1077
2023-05-09 00:00:00,377,693,0,1070,1078
2023-05-10 00:00:00,281,554,0,835,1079
2023-05-11 00:00:00,317,627,0,944,1080
2023-05-12 00:00:00,246,515,0,761,1081
2023-05-13 00:00:00,183,452,0,635,1082
2023-05-14 00:00:00,188,327,0,515,1083
2023-05-15 00:00:00,51,124,0,175,1084
2023-05-16 00:00:00,145,344,0,489,1085
2023-05-17 00:00:00,218,633,0,851,1086
2023-05-18 00:00:00,151,358,1,510,1087
2023-05-19 00:00:00,140,442,0,582,1088
2023-05-20 00:00:00,167,553,0,720,1089
2023-05-21 00:00:00,100,321,0,421,1090
2023-05-22 00:00:00,103,206,0,309,1091
2023-05-23 00:00:00,174,580,1,755,1092
2023-05-24 00:00:00,144,518,0,662,1093
2023-05-25 00:00:00,108,377,0,485,1094
2023-05-26 00:00:00,116,473,0,589,1095
2023-05-27 00:00:00,120,405,0,525,1096
2023-05-28 00:00:00,50,264,0,314,1097
2023-05-29 00:00:00,40,264,0,304,1098
2023-05-30 00:00:00,118,514,0,632,1099
2023-05-31 00:00:00,67,384,0,451,1100
2023-06-01 00:00:00,52,295,0,347,1101
2023-06-02 00:00:00,48,203,0,251,1102
2023-06-03 00:00:00,72,384,0,456,1103
2023-06-04 00:00:00,64,241,0,305,1104
2023-06-05 00:00:00,41,246,0,287,1105
2023-06-06 00:00:00,107,501,1,609,1106
2023-06-07 00:00:00,42,484,0,526,1107
2023-06-08 00:00:00,49,318,0,367,1108
2023-06-09 00:00:00,42,391,0,433,1109
2023-06-10 00:00:00,38,381,0,419,1110
2023-06-11 00:00:00,31,299,0,330,1111
2023-06-12 00:00:00,17,271,0,288,1112
2023-06-13 00:00:00,37,475,0,512,1113
2023-06-14 00:00:00,38,447,0,485,1114
2023-06-15 00:00:00,28,372,0,400,1115
2023-06-16 00:00:00,25,333,0,358,1116
2023-06-17 00:00:00,16,349,0,365,1117
2023-06-18 00:00:00,8,174,0,182,1118
2023-06-19 00:00:00,22,296,0,318,1119
2023-06-20 00:00:00,20,390,1,411,1120
2023-06-21 00:00:00,19,430,0,449,1121
2023-06-22 00:00:00,19,300,0,319,1122
2023-06-23 00:00:00,8,341,0,349,1123
2023-06-24 00:00:00,10,251,0,261,1124
2023-06-25 00:00:00,16,195,0,211,1125
2023-06-26 00:00:00,17,238,0,255,1126
2023-06-27 00:00:00,17,311,0,328,1127
2023-06-28 00:00:00,9,235,0,244,1128
2023-06-29 00:00:00,5,84,0,89,1129
2023-06-30 00:00:00,3,98,0,101,1130
2023-07-01 00:00:00,5,202,0,207,1131
2023-07-02 00:00:00,3,215,0,218,1132
2023-07-03 00:00:00,7,156,0,163,1133
2023-07-04 00:00:00,14,426,0,440,1134
2023-07-05 00:00:00,6,285,0,291,1135
2023-07-06 00:00:00,11,252,0,263,1136
2023-07-07 00:00:00,6,235,0,241,1137
2023-07-08 00:00:00,14,165,0,179,1138
2023-07-09 00:00:00,3,135,0,138,1139
2023-07-10 00:00:00,4,140,0,144,1140
2023-07-11 00:00:00,9,319,0,328,1141
2023-07-12 00:00:00,7,227,0,234,1142
2023-07-13 00:00:00,5,162,0,167,1143
2023-07-14 00:00:00,6,217,0,223,1144
2023-07-15 00:00:00,10,176,0,186,1145
2023-07-17 00:00:00,1,107,0,108,1146
2023-07-18 00:00:00,8,192,0,200,1147
2023-07-19 00:00:00,1,95,0,96,1148
2023-07-20 00:00:00,4,124,0,128,1149
2023-07-21 00:00:00,6,178,0,184,1150
2023-07-22 00:00:00,7,315,0,322,1151
2023-07-23 00:00:00,0,85,0,85,1152
2023-07-24 00:00:00,0,156,0,156,1153
2023-07-25 00:00:00,4,239,0,243,1154
2023-07-26 00:00:00,2,232,0,234,1155
2023-07-27 00:00:00,1,249,0,250,1156
2023-07-28 00:00:00,2,286,0,288,1157
2023-07-29 00:00:00,3,137,0,140,1158
2023-07-30 00:00:00,0,72,0,72,1159
2023-07-31 00:00:00,2,140,0,142,1160
2023-08-01 00:00:00,7,330,0,337,1161
2023-08-02 00:00:00,3,351,0,354,1162
2023-08-03 00:00:00,3,206,0,209,1163
2023-08-04 00:00:00,1,376,0,377,1164
2023-08-05 00:00:00,1,99,0,100,1165
2023-08-06 00:00:00,0,74,0,74,1166
2023-08-07 00:00:00,0,150,0,150,1167
2023-08-08 00:00:00,1,140,0,141,1168
2023-08-09 00:00:00,3,138,0,141,1169
2023-08-10 00:00:00,2,129,0,131,1170
2023-08-11 00:00:00,0,60,0,60,1171
2023-08-12 00:00:00,3,69,0,72,1172
2023-08-13 00:00:00,1,99,0,100,1173
2023-08-14 00:00:00,1,68,1,70,1174
2023-08-15 00:00:00,7,98,0,105,1175
2023-08-16 00:00:00,1,129,0,130,1176
2023-08-17 00:00:00,0,72,0,72,1177
2023-08-18 00:00:00,1,60,0,61,1178
2023-08-19 00:00:00,1,117,0,118,1179
2023-08-20 00:00:00,2,65,0,67,1180
2023-08-21 00:00:00,0,55,0,55,1181
2023-08-22 00:00:00,3,134,0,137,1182
2023-08-23 00:00:00,3,72,0,75,1183
2023-08-24 00:00:00,0,90,0,90,1184
2023-08-25 00:00:00,1,63,0,64,1185
2023-08-26 00:00:00,1,63,0,64,1186
2023-08-27 00:00:00,0,41,0,41,1187
2023-08-28 00:00:00,1,56,0,57,1188
2023-08-29 00:00:00,0,109,0,109,1189
2023-08-30 00:00:00,0,64,0,64,1190
2023-08-31 00:00:00,2,68,0,70,1191
2023-09-01 00:00:00,1,97,0,98,1192
2023-09-02 00:00:00,0,66,0,66,1193
2023-09-03 00:00:00,0,34,0,34,1194
2023-09-04 00:00:00,0,67,0,67,1195
2023-09-05 00:00:00,1,92,0,93,1196
2023-09-06 00:00:00,4,100,0,104,1197
2023-09-07 00:00:00,1,79,0,80,1198
2023-09-08 00:00:00,1,95,0,96,1199
2023-09-09 00:00:00,0,94,0,94,1200
2023-09-10 00:00:00,0,33,0,33,1201
2023-09-11 00:00:00,1,38,0,39,1202
2023-09-12 00:00:00,1,102,0,103,1203
2023-09-13 00:00:00,0,81,0,81,1204
2023-09-14 00:00:00,0,87,0,87,1205
2023-09-15 00:00:00,1,85,0,86,1206
2023-09-16 00:00:00,0,67,0,67,1207
2023-09-17 00:00:00,0,36,0,36,1208
2023-09-18 00:00:00,1,45,0,46,1209
2023-09-19 00:00:00,1,78,0,79,1210
2023-09-20 00:00:00,1,80,0,81,1211
2023-09-21 00:00:00,0,62,0,62,1212
2023-09-22 00:00:00,1,69,0,70,1213
2023-09-23 00:00:00,1,61,0,62,1214
2023-09-24 00:00:00,0,33,0,33,1215
2023-09-25 00:00:00,0,38,0,38,1216
2023-09-26 00:00:00,1,109,0,110,1217
2023-09-27 00:00:00,0,60,0,60,1218
2023-09-28 00:00:00,1,22,0,23,1219
2023-09-29 00:00:00,0,47,0,47,1220
2023-09-30 00:00:00,1,94,0,95,1221
2023-10-01 00:00:00,0,40,0,40,1222
2023-10-02 00:00:00,2,29,0,31,1223
2023-10-03 00:00:00,1,58,0,59,1224
2023-10-04 00:00:00,0,69,0,69,1225
2023-10-05 00:00:00,2,59,0,61,1226
2023-10-06 00:00:00,1,90,0,91,1227
2023-10-07 00:00:00,1,60,0,61,1228
2023-10-08 00:00:00,0,23,0,23,1229
2023-10-09 00:00:00,1,25,0,26,1230
2023-10-10 00:00:00,2,98,0,100,1231
2023-10-11 00:00:00,1,77,0,78,1232
2023-10-12 00:00:00,0,32,0,32,1233
2023-10-13 00:00:00,1,85,0,86,1234
2023-10-14 00:00:00,0,49,0,49,1235
2023-10-15 00:00:00,0,61,0,61,1236
2023-10-16 00:00:00,0,16,0,16,1237
2023-10-17 00:00:00,1,97,0,98,1238
2023-10-18 00:00:00,0,45,0,45,1239
2023-10-19 00:00:00,0,51,0,51,1240
2023-10-20 00:00:00,1,21,0,22,1241
2023-10-21 00:00:00,1,26,0,27,1242
2023-10-22 00:00:00,0,19,0,19,1243
2023-10-23 00:00:00,1,61,0,62,1244
2023-10-24 00:00:00,1,33,0,34,1245
2023-10-25 00:00:00,1,50,0,51,1246
2023-10-26 00:00:00,3,43,0,46,1247
2023-10-31 00:00:00,0,56,0,56,1248
2023-11-01 00:00:00,4,40,0,44,1249
2023-11-02 00:00:00,2,55,0,57,1250
2023-11-03 00:00:00,3,24,0,27,1251
2023-11-04 00:00:00,1,44,0,45,1252
2023-11-07 00:00:00,2,37,0,39,1253
2023-11-08 00:00:00,2,46,0,48,1254
2023-11-09 00:00:00,1,41,0,42,1255
2023-11-10 00:00:00,4,32,0,36,1256
2023-11-11 00:00:00,1,36,0,37,1257
2023-11-12 00:00:00,1,51,0,52,1258
2023-11-13 00:00:00,0,12,0,12,1259
